###############
#     @     * #
#             #
#             #
#    X        #
#             #
#         *   #
#   *         #
#             #
#             #
#        *    #
#             #
#   *         #
#             #
###############
