###############
#     @ #2a#  #
#       ##b#  #
#             #
#    X        #
#             #
#             #
#             #
#             #
#             #
#             #
#             #
#             #
#             #
###############
