###############
#     @ b1#   #
#       ###   #
#             #
#             #
#             #
#             #
#             #
#             #
#   X         #
#             #
#             #
#             #
#             #
###############
